3
+--+--+--+
   |  |  |
+  +  +  +
|  |  |  |
+  +  +  +
|         
+--+--+--+